0 356

11 11
0	1	2	3	4	5	6	7	8	9	100
10	11	12	13	14	15	16	17	18	19	110
20	21	22	23	24	25	26	27	28	29	120
30	31	32	33	34	35	36	37	38	39	130
40	41	42	43	44	45	46	47	48	49	140
50	51	52	53	54	55	56	-1	58	59	150
60	61	604	-1	64	65	66	611	68	69	160
70	71	-1	73	74	75	76	77	78	79	170
80	-1	82	83	603	85	86	87	88	89	180
90	91	92	93	94	95	-1	97	98	99	190
200	201	202	203	204	205	206	207	208	209	300

11 11
100	101	102	103	104	105	106	107	108	109	200
110	111	112	113	114	115	116	117	118	119	210
120	121	-1	-1	-1	-1	-1	-1	128	129	220
130	131	-1	-1	-1	-1	-1	-1	138	139	230
140	141	-1	401	402	403	-1	-1	148	149	240
150	151	-1	-1	400	-1	-1	-1	158	159	250
160	161	162	163	164	165	166	167	168	169	260
170	171	172	173	174	175	176	177	178	179	270
180	181	182	183	184	185	186	187	188	189	280
190	191	192	193	194	195	196	197	198	199	290
300	301	302	303	304	305	306	307	308	309	0

11 11
200	201	202	203	204	205	206	207	208	209	300
210	211	212	213	214	215	216	217	218	219	310
220	221	222	223	224	225	226	227	228	229	320
230	231	232	233	234	235	606	237	238	239	330
240	241	610	243	244	245	246	247	248	249	340
250	251	252	253	254	255	256	257	258	259	-1
260	-1	262	263	264	265	266	605	268	269	360
270	271	272	-1	274	275	-1	277	278	279	370
280	281	282	283	284	285	286	287	288	289	380
290	291	292	293	294	295	296	297	298	299	390
0	1	2	3	4	5	6	7	8	9	100

11 11
300	301	302	303	304	305	306	307	308	309	0
310	311	312	313	314	315	316	317	318	319	10
320	321	322	323	324	325	326	327	328	329	20
330	331	332	333	602	-1	336	-1	-1	339	30
340	341	342	343	609	345	346	347	348	-1	40
-1	600	352	353	-1	355	356	357	-1	359	50
360	361	362	-1	364	365	366	367	368	369	60
370	608	372	373	-1	375	376	601	-1	379	70
380	381	382	383	384	607	-1	387	388	389	80
390	391	392	393	394	395	396	397	398	399	90
100	101	102	103	104	105	106	107	108	109	200

5 11
-1	-1	435	-1	-1	-1	-1	436	-1	-1	-1
413	414	415	416	-1	418	419	420	421	-1	-1
409	410	411	412	417	422	423	424	425	-1	-1
405	406	407	408	-1	426	427	428	429	-1	-1
401	402	403	404	-1	430	431	432	433	434	434b

5 10
-1	462	463	464	465	-1	466	467	468	469
-1	454	455	456	457	470	458	459	460	461
437g	446	447	448	449	-1	450	451	452	453
-1	438	439	440	441	-1	442	443	444	445
-1	-1	-1	435	-1	-1	-1	437	-1	-1

2 1
471
436

4 6
486	-1	488	489	-1	-1
482	-1	484	485	-1	409
478	479	480	481	472	405
474	475	476	477	-1	401

4 5
502	-1	504	505	-1
498	-1	500	501	-1
494	495	496	497	473
490	491	492	493	-1

1 3
486	487	504

1 3
502	503	488

4 5
-1	518	519	520	521
-1	514	515	516	517
473	510	511	512	513
-1	506	507	508	509

0 0

0 399 1
400 400 20
417 417 17
435 437 17
470 470 17
472 473 17
345 348 4
336 336 4
364 368 4
375 376 4
434 434 3
346 347 3
355 357 3
365 366 3
506 599 2
600 700 32
