0 0

11 11
-1	-1	-1	-1	-1	-1	80	81	82	83	84
-1	-1	-1	-1	-1	-1	75	76	77	78	79
-1	-1	-1	-1	-1	-1	70	71	72	73	74
-1	-1	-1	-1	-1	-1	65	66	67	68	69
-1	-1	-1	-1	60g	-1	60	61	62	63	64
85	86	87	88	89	-1	55	56	57	58	59
0	1	2	3	4	5	6	7	8	9	10
11	12	13	14	15	16	17	18	19	20	21
22	23	24	25	26	27	28	29	30	31	32
33	34	35	36	37	38	39	40	41	42	43
44	45	46	47	48	49	50	51	52	53	54

2 1
60g
89

2 1
52
90

13 11
91	92	93	94	95	96	97	98	99	100	151
101	102	103	104	105	106	107	108	109	110	161
111	112	113	114	115	116	117	118	119	120	171
121	122	123	124	125	126	127	128	129	130	181
131	132	133	134	-1	-1	-1	138	139	140	191
141	142	143	144	-1	-1	-1	148	149	150	201
151	152	153	154	-1	90	-1	158	159	160	91
161	162	163	164	165	166	167	168	169	170	101
171	172	173	174	175	176	177	178	179	180	111
181	182	183	184	185	186	187	188	189	190	121
191	192	193	194	195	196	197	198	199	200	131
201	202	203	204	205	206	207	208	209	210	141
91	92	93	94	95	96	97	98	99	100	151

0 0

90 90 17

